11111111111111111111
10000000000000000001
10010010001111100001
10010010000000100001
10011110001111100001
10000010001000000001
10000010001111100001
10000000000000000001
11111111111111111111