11111111111111111111
10000000000000000001
10011111000011000001
10000000000000000001
10100010000011110001
10000000000010000001
10010000000010000001
10000000000000000001
11111111111111111111