NO assets/e6/crate.xpm
SO assets/e6/crate2.xpm
WE assets/e6/console.xpm
EA assets/e6/support.xpm

C 0, 0, 0
F 46, 46, 46

1111111111111111111111111111111111111111111111111
1000000000000000000000000000000000000000000000001
1000101000000000000000000000000000000000000000001
1000000000000000000000000000000010000000000000001
1000000000000000000000000000000000000000000000001
1000001000000000000000000000000100000000000000001
1000000000000000000000000000000000000000000000001
1000000000000000000001111111111000001111111111111
1000000000000000000001        1000001
1000000000000010000001        100000111111111111111111111111111111111111111111111111111111111111111
10000011100000S0000001        100000000000000000000000000000000000000000000000000000000000000000001
1000001 10000000000001        100000000000000000000000000000000000000000000000000000000000000000001
1000001 11111101111111        111111111111111111111111111111111111111111100000111111111111111111111
1000001      101                                                        1100011
10000011111111011111111111111111111111111111111111                      1100011
10000000000000000000000000000000000000000000000001                      1100011
10000011111111011111111111111111111111111111111111                      1100011
10000011111111011111111111111111111111111                               1100011
10000011111111011111111111111111111111111                               1110011
10000000000000000000000000000000000000001                               1110111
10000000000000000000000000000000000000001                               1110111
10000000000000000000000000000000000000001             111111111111111111111011111111111111111111111
10111100111100110011110011110011101111001             100000000000001000000000000010000000000000001  
101  1001  1001 101  1001  1001 101  1001              1000000000000010000000000010000000000000001
101  1001  1001 101  1001  1001 101  1001               10000000000000100000000010000000000000001
111  1111  1111 111  1111  1111 111  1111                100000000000001000000010000000000000001
                                                          1000000000000010000010000000000000001
                     111                                   11000000000000100010000000000000011
                     101                                    11111111111111100111111111111111
                     101                                      111111111111100111111111111111
                     101                                       1111111111110111111111111111
111111111111111111111101111111111111111111111111111111111111111111111111111011111111111111
10000000000000000000000000000000000000000000000000000000000000000000000000001
11111111111111111111111111111111111111111111111111111111111111111111111111111