NO assets/console.xpm
SO assets/support.xpm
WE assets/tile.xpm
EA assets/crate.xpm

C 122, 122, 122
F 92, 64, 51

1111111111111111111111111111111111111111111111111
1000000000000000000000000000000000000000000000001
1000101000000000000000000000000000000000000000001
1000000000000000000000000000000010000000000000001
1000000000000000000000000000000000000000000000001
1000001000000000000000000000000100000000000000001
1000000000000000000000000000000000000000000000001
1000000000000000000001111111111111111111111111111
1000000000000000000001
1000000000000010000001
10000011100000S0000001
1000001 10000000000001  
1000001 11111101111111  
1000001      101          
10000011111111011111111111111111111111111111111111        
10000000000000000000000000000000000000000000000001
10000011111111011111111111111111111111111111111111
10000011111111011111111111111111111111111
10000011111111011111111111111111111111111
10000000000000000000000000000000000000001
10000000000000000000000000000000000000001
10000000000000000000000000000000000000001
10111100111100110011110011110011101111001
101  1001  1001 101  1001  1001 101  1001
101  1001  1001 101  1001  1001 101  1001
111  1111  1111 111  1111  1111 111  1111 