11111111111111111111
10000000000000000001
10011110000110001001
10000000000000000001
10100010000011110001
10000000000010010001
11110000000010010001
10000000000000000001
11111111111111111111