NO assets/bricks.xpm
SO assets/bricks2.xpm
WE assets/woodplanks.xpm
EA assets/woodplanks2.xpm

C 135, 206, 235
F 205, 133, 0

11111111111111111111111111111111111
10000000000000000000000000000000001
10000000000000000000000000000000001
10000000000000000000000000000000001
10000000000000001000000000000000001
10000000000000000000000000000000001
10000000000000000100000000000000001
10000000000000010000000000000000001
10000000000000000100000000000000001
10000000000000010000000000000000001
10000000000000000100000000000000001
10000000000000100000000000000000001
10000000000000000000000000000000001
1000000000000000N000000000000000001
10000000000000000000000000000000001
11111111111111111111111111111111111
