NO assets/metal.xpm
SO assets/red.xpm
WE assets/blue.xpm
EA assets/green.xpm

C 
F 0, 0, 0

1111111111111111111111111111111111111111111111111
10000S0000000000000000000000000000000000000000001
1000101000000000000000000000000000000000000000001
1000000000000000000000000000000000000000000000001
1000000000000000000000000000000000000000000000001
1000000000000000000000000000000000000000000000001
1000000000000000000000000000000000000000000000001
1000000000000000000001111111111111111111111111111
1000000000000000000001
1000000000000000000001
1000001110000000000001
1000001 10000000000001  
1000001 11111111111111  
1000001                  
1000001                
1000001                 
1000001  
1000001
10000011111111111111111111111111111111111
10000011000000000000001100000001100000001
10000000000000000000000000000000000000001
10000011000000000000001100000001100000001
11111111111111111111111111111111111111111